.........
.XXXXXXX.
aXXXXXXXb
X.XXXXX.X
XX.XXX.XX
XXX.X.XXX
XXXX.XXXX